11 7
# # # # # # # # # # #
# S . . . # . . . . #
# . # # . # . # # . #
# . # . . . . . # . #
# . # . # # # . # . #
# . . . . . . . . G #
# # # # # # # # # # #
